{
    "gridSize": 48,
    "mapSize": {
        "map1": [23, 15],
        "map2": [24, 16]
    },
    "maps": {
        "map1" : [
            [0, 0, 0], 
            [0, 1, 0], 
            [0, 0, 0]
        ],

        "map2" : [
            [0, 0, 0, 0, 0, 0, 0, 0, 0, 0, 0, 0, 0, 0, 0, 0, 0, 0, 0, 0, 0, 0, 0, 0], 
            [0, 44, 45, 45, 45, 45, 46, 0, 0, 47, 1, 2, 2, 3, 47, 0, 0, 0, 0, 0, 0, 0, 0, 0],  
            [0, 59, 0, 0, 0, 0, 59, 0, 0, 59, 4, 5, 5, 6, 59, 0, 0, 0, 0, 0, 0, 0, 0, 0],             
            [0, 59, 0, 0, 0, 0, 59, 0, 0, 59, 4, 5, 5, 6, 59, 0, 0, 0, 0, 0, 0, 0, 0, 0],             
            [0, 59, 0, 0, 0, 0, 59, 0, 0, 59, 4, 5, 5, 6, 59, 0, 0, 0, 0, 0, 0, 0, 0, 0],             
            [0, 59, 0, 0, 0, 0, 59, 0, 0, 59, 4, 5, 5, 6, 59, 0, 0, 0, 0, 0, 0, 0, 0, 0],             
            [0, 59, 0, 0, 0, 0, 59, 80, 45, 70, 7, 8, 8, 9, 68, 45, 82, 0, 0, 0, 0, 0, 99, 0],             
            [47, 1, 2, 2, 2, 2, 2, 2, 3, 10, 10, 10, 10, 10, 10, 1, 2, 2, 2, 2, 2, 2, 3, 47],             
            [59, 4, 5, 5, 5, 5, 5, 5, 6, 10, 10, 10, 10, 10, 10, 4, 5, 5, 5, 5, 5, 5, 6, 59],             
            [59, 7, 8, 8, 8, 8, 8, 8, 9, 10, 10, 10, 10, 10, 10, 7, 8, 8, 8, 8, 8, 8, 9, 59],             
            [68, 82, 0, 0, 0, 0, 0, 80, 45, 45, 45, 45, 45, 45, 45, 45, 82, 0, 0, 0, 0, 0, 80, 70], 
            [0, 0, 0, 0, 0, 0, 0, 0, 0, 0, 0, 0, 0, 0, 0, 0, 0, 0, 0, 0, 0, 0, 0, 0], 
            [0, 0, 0, 0, 0, 0, 0, 0, 0, 0, 0, 0, 0, 0, 0, 0, 0, 0, 0, 0, 0, 0, 0, 0], 
            [0, 0, 0, 0, 0, 0, 0, 0, 0, 0, 0, 0, 0, 0, 0, 0, 0, 0, 0, 0, 0, 0, 0, 0], 
            [0, 0, 0, 0, 0, 0, 0, 0, 0, 0, 0, 0, 0, 0, 0, 0, 0, 0, 0, 0, 0, 0, 0, 0], 
            [0, 0, 0, 0, 0, 0, 0, 0, 0, 0, 0, 0, 0, 0, 0, 0, 0, 0, 0, 0, 0, 0, 0, 0]  
        ]
    } 
}